11111111111111111111111111111111
10000000000000000000000000000001
1AAAAAAAAA00000000000AAAAAAAAAA1
1AAAAAA00000000000000000AAAAAAA1
1AAAAAA00000000000000000AAAAAAA1
10000000000000000000000000000001
1AAAAAA000000AAAAAA000000AAAAAA1
1AAAAAA000000AAAAAA000000AAAAAA1
1AAAAAA000000AAAAAA000000AAAAAA1
1000000000CCCCCC0000000000000001
1000000000000000CCCCCC0000000001
1CCCC00000000000000000000000CCC1
10000000000000000000000000000001
1000000000000000E00000000000P001
11111111111111111111111111111111
