111111111111111111111111111
100000000000000000000000001
100000000000000000000000001
100000000000000000000000001
100000000000000000000000001
100000000000E00000000000001
100000000000000000000000001
100000000000000100000000001
100000000000000000000000001
100000000000000000000000001
100000000000000000000000001
1000000000000P00000000000C1
111111111111111111111111111