1111111111111
100100C000001
100E011111001
100011000P001
100011000P001
100011000P001
100011000P001
1111111111111