111111111111111111111111111
1AAAAAAAAAAAAAAAAAAAAAAAAA1
1AAAAAAAAAAAAAAAAAAAAAAAAA1
100000000000000000000000001
100000000000000000000000001
100000000000E00000000000001
100000000000000000000000001
100000000000000000000000001
100000000000000000000000001
100000000000000000000000001
100000000000000000000000001
100000000000P000000000000C1
111111111111111111111111111