
11111111
10000001
1A00EC01
10000P01
11111111