111110
100001
100001
1A0001
1P0001
111111